1	2	1	2	3	4	5	6	1	2	3	4	7	8	1	2	3	4	9	10	11	12	13	14	1	2	15	16	3	4	13	14	1	2	15	16	3	4	13	14	1	2	17	18	7	8	19	20
21	22	21	22	23	24	25	26	21	22	23	24	27	28	21	22	23	24	29	30	31	32	33	34	21	22	35	36	23	24	33	34	21	22	35	36	23	24	33	34	21	22	9	37	27	28	38	20
1	2	5	6	23	24	1	2	1	2	23	24	39	39	1	2	23	24	40	41	5	6	1	2	3	4	15	16	23	24	13	14	3	4	15	16	23	24	13	14	3	4	9	10	39	39	19	20
21	22	25	26	23	24	21	22	21	22	23	24	39	39	21	22	23	24	42	43	25	26	21	22	23	24	35	36	23	24	33	34	23	24	35	36	23	24	33	34	23	24	29	30	39	39	38	20
44	45	46	46	46	46	47	48	49	50	23	24	39	39	1	2	23	24	51	52	1	2	1	2	23	24	1	2	23	24	1	2	23	24	1	2	23	24	7	8	23	24	51	52	39	39	53	54
55	55	55	55	55	55	55	56	57	58	23	24	39	39	21	22	23	24	59	60	21	22	21	22	23	24	21	22	23	24	21	22	23	24	21	22	23	24	27	28	23	24	59	60	39	39	53	61
9	10	1	2	3	4	11	12	56	62	46	46	44	45	46	46	46	46	47	48	49	50	1	2	23	24	1	2	23	24	1	2	23	24	1	2	23	24	5	6	23	24	63	64	65	66	53	67
29	30	21	22	23	24	31	32	55	55	55	55	55	55	55	55	55	55	55	56	57	58	21	22	23	24	21	22	23	24	21	22	23	24	21	22	23	24	25	26	23	24	68	65	69	55	55	55
51	52	1	2	23	24	1	2	7	8	23	24	5	6	23	24	5	6	11	12	56	57	49	50	23	24	1	2	23	24	1	2	23	24	1	2	23	24	1	2	23	24	70	69	71	72	19	20
59	60	21	22	23	24	21	22	27	28	23	24	25	26	23	24	25	26	31	32	73	56	57	58	23	24	21	22	23	24	21	22	23	24	21	22	23	24	21	22	23	24	55	55	74	75	38	20
44	45	44	45	76	77	44	45	44	45	76	77	44	45	76	77	44	45	44	45	44	45	56	62	76	77	44	45	76	77	44	45	76	77	44	45	76	77	44	45	76	77	44	45	44	45	78	20
55	55	55	55	55	55	55	55	55	55	55	55	55	55	55	55	55	55	55	55	55	55	55	55	55	55	55	55	55	55	55	55	55	55	55	55	55	55	55	55	55	55	55	55	55	55	55	55	