1	1	1	1	2	3	4	4	5	6	4	4	7	8	9	10	1	1	1	1	1	1	1	1	1	1	1	1	1	1	1	1	1	1	1	1	1	1	1	1	1	1	1	1	11	12	13	14	1
1	1	15	16	17	2	4	4	18	19	4	4	7	8	20	21	15	16	15	16	15	16	15	16	4	4	4	4	15	16	4	4	15	16	15	16	4	4	15	16	4	4	15	16	22	23	13	14	1
1	1	16	24	4	4	2	3	4	4	4	4	7	8	25	26	16	24	11	12	27	28	16	24	5	6	11	12	27	28	9	10	16	24	11	12	27	28	5	6	11	12	27	28	29	30	13	14	1
1	1	31	16	4	4	17	2	4	4	4	4	7	8	32	33	31	16	22	23	23	34	31	16	18	19	22	23	23	34	20	21	31	16	22	23	23	34	18	19	22	23	23	34	35	36	13	14	1
1	1	4	4	4	4	4	4	2	3	5	6	7	8	16	24	5	6	23	23	23	23	5	6	16	24	37	23	38	39	25	26	4	4	37	23	23	23	16	24	23	23	23	23	16	24	13	14	1
1	1	4	4	4	4	4	4	17	2	18	19	7	8	31	16	18	19	40	41	42	39	18	19	31	16	43	23	44	44	32	33	4	4	43	23	45	23	31	16	40	41	42	39	31	16	13	14	1
1	1	5	6	4	4	1	1	1	1	1	1	7	8	29	30	16	24	29	30	38	39	16	24	5	6	46	23	44	44	16	24	4	4	46	23	46	23	5	6	23	23	44	44	4	4	1	1	1
1	1	18	19	4	4	15	16	15	16	15	16	7	8	35	36	31	16	35	36	44	44	31	16	18	19	47	23	44	44	31	16	4	4	47	23	47	23	18	19	40	41	44	44	4	4	44	48	1
1	1	1	1	4	4	5	6	4	4	16	24	7	8	16	24	5	6	1	1	16	24	4	4	4	4	1	1	16	24	5	6	4	4	16	24	16	24	16	24	16	24	4	4	4	4	44	49	1
1	1	15	16	4	4	18	19	4	4	31	16	7	8	31	16	18	19	15	16	31	16	4	4	4	4	15	16	31	16	18	19	4	4	31	16	31	16	31	16	31	16	4	4	4	4	44	50	1
1	1	4	4	1	1	1	1	4	4	4	4	7	8	4	4	4	4	4	4	4	4	4	4	4	4	4	4	4	4	4	4	4	4	4	4	4	4	4	4	4	4	1	1	1	1	1	1	1
1	1	4	4	15	16	15	16	1	1	1	1	1	1	1	1	1	1	1	1	1	1	1	1	1	1	1	1	1	1	1	1	1	1	1	1	1	1	1	1	1	1	1	1	1	1	1	1	1	