1	1	2	3	4	4	4	4	2	3	5	5	5	5	5	5	5	5	5	5	5	5	5	5	5	5	5	5	5	5	5	5	5	5	5	5	5	5	5	5	5	5	5	5	5	5	1	1
1	1	6	2	4	4	4	4	6	2	5	5	5	5	5	5	5	5	5	5	5	5	5	5	5	5	5	5	5	5	5	5	5	5	5	5	5	5	5	5	5	5	5	5	5	5	1	1
1	1	4	4	4	4	7	8	4	4	5	5	5	5	5	5	4	9	4	9	5	5	5	5	5	5	5	5	10	11	5	5	5	5	5	5	5	5	5	5	5	5	4	9	4	9	1	1
1	1	4	4	4	4	12	13	4	4	5	5	5	5	5	5	4	4	4	4	5	5	5	5	5	5	5	5	14	15	5	5	5	5	5	5	5	5	5	5	16	17	4	4	4	4	1	1
1	1	4	4	4	4	2	3	4	4	5	5	5	5	10	11	18	19	20	21	10	11	5	5	5	5	5	5	22	23	4	9	4	9	4	9	4	9	24	17	25	25	7	8	4	4	1	1
1	1	4	4	4	4	6	2	4	4	5	5	5	5	14	15	26	5	5	27	14	15	5	5	5	5	5	5	28	4	4	4	4	4	4	4	4	4	25	25	25	25	12	13	4	4	25	29
1	1	4	4	7	8	22	23	1	1	5	5	20	21	1	1	5	5	5	5	4	4	10	11	10	11	4	9	30	31	4	4	4	4	1	1	32	33	2	3	7	8	4	4	4	4	25	34
1	1	4	4	12	13	28	4	1	1	5	5	5	27	4	4	35	36	5	5	4	4	14	15	14	15	4	4	37	38	1	1	4	4	39	2	40	32	6	2	12	13	4	4	1	1	25	41
1	1	4	4	22	23	4	4	4	4	24	17	24	17	7	8	2	3	2	3	4	4	4	4	22	23	1	1	2	3	10	11	4	4	18	19	20	21	32	33	4	4	4	4	2	3	1	1
1	1	4	4	28	4	4	4	4	4	25	25	25	25	12	13	6	2	6	2	4	4	4	4	28	4	39	2	6	2	14	15	4	4	26	5	5	27	40	32	4	4	1	1	6	2	1	1
1	1	1	1	42	1	7	8	7	8	1	1	1	1	1	1	1	1	1	1	10	11	1	1	4	4	5	5	1	1	4	4	4	4	5	5	10	11	1	1	1	1	4	4	4	4	1	1
1	1	1	1	2	43	12	13	12	13	4	4	39	2	39	2	39	2	4	4	14	15	39	2	4	4	35	36	39	2	1	1	1	1	35	36	14	15	39	2	39	2	4	4	4	4	1	1	