1	2	3	4	2	2	2	2	5	6	7	8	3	4	1	1
1	2	9	4	2	2	2	2	6	2	10	11	9	4	1	1
1	2	9	4	2	2	5	6	2	2	12	13	9	4	1	1
1	2	9	4	2	2	14	2	2	2	15	16	9	4	1	1
1	1	17	18	5	6	19	11	20	21	2	2	9	4	1	1
1	1	1	1	1	1	1	1	1	1	2	2	9	4	1	1
1	1	3	4	12	22	2	2	2	2	2	2	17	18	1	1
1	1	9	4	15	16	23	2	2	2	24	1	1	1	1	1
25	8	9	4	2	2	2	2	5	6	2	2	7	8	1	1
26	27	9	4	2	2	2	2	6	2	2	2	10	11	1	1
28	29	17	18	10	11	5	6	20	21	20	21	10	11	1	1
1	1	1	1	1	1	1	1	1	1	1	1	1	1	1	1	